#############################
#                           #
#    O                      #
#                X          #
#  X                        #
#                           #
#                           #
#                    O      #
#                           #
#                           #
#                        O  #
#                           #
#    P             X        #
#                           #
#############################